######################################################################################
#   *  #                      #                       #                              #
#      #                      #                                                      #
#      #             ##########                       #                              #
#                                                     #                              #
#                                                     ####                           #
#                                                        #                           #
#                                                                                    #
#            ######################################             #################  ###
#                                                                                    #
#                                                                                    #
#                                                                                    #
#                                                                                    #
#            ######################################             #################  ###
#                                               #                                    #
#                                               #                                    #
#                                               #             3                      #
#                                               #                                8   #
#                                               #                #                   #
#                                               #                #                   #
#                                                                #                   #
#                                                              ### ###################
#         7                         #                          #                     #
#                                   #                          #                     #
#                                   #                          #                     #
#                                   #                 ####### ##                     #
#####################################                 #                              #
#                                   #                 #                              #
#                                   #                 #                              #
#                                                     #                              #
#                 1                                 ###                         8    #
#                                            ########                                #
#                                            #  e                                    #
#                                                                                    #
######################################################################################
