###############################################################
#*        #   2                       #   8                   #
#    ############     ###################################     #
#                          #   4                              #
#          #############################      #################
#                                                             #
####################        ########################    #######
#          9 #                                                #
#      #############################      ##################  #
#                              5 #                       # 3  #
#### ######################  ####################     #########
#            #                                                #
########################################################  ### #
#                    7    #                                #e #
#         ###############################       ###############
#                                                    #  8     #
###############    #######################  ###############   #
#                            #  4                             #
#  ############################################################
#                         3  #                6    #   9      #
#################   ##################      ###############   #
# 1                                                           #
###############################################################
