################################################
#   1  #    #       3#     #          #1   #  2#
#*          #    #   #  1        #  1 #       e#
#      #  2     3#         #    2#         #  2#
################################################
