#####################
#*         1        #
# ######### ####### #
# ##     4# ####### #
#2## ###### #######2#
# ## ##1        1####
# ## ###### #### ## #
# ## #1          ## #
#1## ### ##########e#
#                   #
#####################
