##########
#        #
#   #    #
#   #    #
#   #    #
#  *#   e#
##########
