###############
#      #  5   #
# e    #   #  #
#          # 4#
###### ########
# *         #3#
###############